wwwwwwhwwwww
wss.,..pp.tw
w.p.....p.tw
wss..ttttppw
ws....ttt.tw
ws..B..ttppw
wp......t.pw
wspp....tppw
ws........pw
wps.......tw
wpps.P.....w
ws..ss.....w
ws.........w
ws......p.pw
wstststststw
