wwwwwwwhwwww
s.....sPs.s...................................
s..ff.s.s.....................................
s..s.ss.s.s...................................
s..s.ss.sfs...................................
s..s.ss.s.s...................................
s..s....s.s...................................
s..ssssssfs...................................
s..ffsfs..s...................................
s..sssfs.ss...................................
s...f..s.ss...................................
s..sssss.ssf..................................
s........sff..................................
ssssssssssss..................................
