wwwwwwhwwwww
w.s....pp.tw
wps.....p.tw
w.s..ttttppw
w.....ttt.tw
w......ttppw
wp......t.pw
w.pp....tppw
ws........pw
wps.......tw
wpps.P.....w
w...ss.....w
w..........w
w.......p.pw
wstststststw