wwwwwwhwwwwwwwww
w..f...........w
w.bb...p.......w
w...fBBf.......w
w....tt.p......w
w..B..t........w
w.....bf.......w
wff...tt.......w
wf...b.........w
w.p.....bb.....w
w...P...b......w
w...bppbb......w
w.B...p........w
w.bppbb....pfp.w
wwwwwwwwwwwwwwww
