wwwwwwhwww
.s.f......
psb..b.p..
.s..fBBf..
.....tt...
...B..t...
......bf..
.ff...tt..
.f........
........b.
....P...b.
...ss.....
..B.......
.......pfp
ssssssssss