wwwwwwhwww
.s.f..pp.t
ps.....p.t
.s..ttttpp
.....ttt.t
...B..ttpp
p......t.p
.pp....tpp
s........p
ps.......t
pps.P.....
...ss.....
..........
.......pfp
ststststst