wwwwwwhwww
.s.f.....t
psb..b.p.t
.s..fBBf.t
.........t
.........t
......bf.t
.ff...tt.t
.f.......t
........bt
....P.Q.bt
...ss....t
..B......t
.......pft
ssssssssss