wwwwwwhwww
ss.,..pp.t
.p.....p.t
ss..ttttpp
s....ttt.t
s..B..ttpp
p......t.p
spp....tpp
s........p
ps.......t
pps.......
s..ss..P..
s.........
s.........
ststststst
