wwwwwwwwwwwwwwwww
w.s..s...j......w
w.s......j..s...w
ws..j...j.......w
wBj......j..s..sw
w.j........j....w
wF..s..sjs...j.Hw
wwwwwwwwwwwwwwwww
