wwwwwwhwww
.s....pp.t
ps.....p.t
.s..ttttpp
.....ttt.t
......ttpp
p......t.p
.pp....tpp
s........p
ps.......t
pps.P.....
...ss.....
..........
.......p.p
ststststst