wwwwwwwwwwwwwwwwww
..s..s...j......
..s......j..s...
..s..j...j......
.Bj......j..s..s
..j...j....j....
...Fs..sjs...j.hs
wwwwwwwwwwwwwwwws
