wwwwwwhwww
s....sPs..
s..s.s.s..
s..s.s.sss
s..s.s...p
H..s.sssss
...s.s...s
.pps.s...s
.pps.s.s.s
ssss.s.s.s
s....s.s.s
s.ssss.sps
s....p.s..
s......s..
sssssssstt