wwwwwwhwww
ss..b....t
.p.....p.t
ss..ttttpp
s....ttt.t
s..B..ttpp
p......t.p
spp.f..tpp
s........p
ps...W...t
pps.P.....
s..ss.....
s.........
ststststst
