wwwwwwhwww
ss.,..pp.t
.p.....p.t
ss..ttttpp
s....ttt.t
s..B..ttpp
p......t.p
spp....tpp
s........p
ps.......t
pps.P.....
s..ss.....
s.........
s......p.p
ststststst
